000|000|000|000|000|000|000|000|000|000|000|000|000|000|000|000|000|000|000|000|000|000|000|000|000|000|000|000|000|000|000|000|000|000|000
000|000|000|000|000|000|000|000|000|000|000|000|000|000|000|000|000|000|000|000|000|000|000|000|000|000|000|000|000|000|000|000|000|000|000
000|000|000|000|000|043|000|000|000|000|000|000|000|000|000|000|000|000|000|000|000|000|000|000|000|000|000|000|000|000|000|000|043|000|000
000|000|000|000|000|067|000|000|000|000|000|000|000|000|000|000|000|000|000|000|000|000|000|000|000|000|000|000|000|000|000|000|067|000|000
000|000|000|000|000|066|065|064|068|000|000|000|000|066|064|065|067|064|065|068|000|000|000|000|066|064|065|064|065|064|065|064|068|000|000
000|000|000|000|000|066|065|064|068|000|000|000|000|066|064|065|067|064|065|068|000|000|000|000|066|064|065|064|065|064|065|064|068|000|000
000|000|000|000|000|066|064|065|064|065|064|065|064|065|064|065|064|065|064|065|064|065|064|065|064|065|064|065|064|065|064|065|068|000|000